11111111111111111111111111111111
10000011111111000000100000000001
10300000000001000000100000000001
10010000000001111100101100001001
10011110011000000000000000001001
10000010010000000000000001111001
10000000010000100100000000001001
10011000011111100111100000001001
10001110000100000000100111001001
11000011100100000000100001001001
11110000111100000000100001000001
11111000000100111111111111000001
11111110000000001000000000001001
11100011110000001000000000001001
10000000000001111111001111111111
10000000000001000010040010000001
11100011110011000010000010000001
10000010000000001111000111001111
10000000010000001000000001001111
11100011110011111000000000001111
10000000000000000001111000001111
10000010000000000001111100001111
10000010000001000000000000000001
11111111111111111111111111111111