11111111111111111111111111111111
10000000111100000000000000000001
10000000000000000000000000000001
10000000000000011100000000000001
11100011111000010000000000000001
10000000001000010000000000000001
10001000001001111100111111110111
10001001111000000000000000110001
10000000001001110000000000110001
10000000001001110001111111110001
10001111001000000000000000000001
10000000000000000000000000000001
10000000000111110001111111001001
10011101000100010001000001001111
10010001111100010001000000000001
10010000000000011111000000000001
10011111001110000000000010010001
10000000001110000000000010010001
10011001001110011111000011111111
10000001000000010001001111111001
10001111100000010001000011100001
10001000000000000000000000000001
10001011100000000000000000000001
10001111111111111111111111111111