11111111111111111111111111111111
10000000000000000000000000000001
10000000000000000000000000000001
10000000000000000000000000000001
10000000000000010000000000000001
10000000001000010000000000000001
10000000001001111100000000000001
10001111111000000000000000000001
10000000001001110000000000000001
10000000001001000000000000000001
10000011111111111111111111000001
10000000000000000000000000000001
10000000000000000000000000000001
10000200000000000000000000000001
10000000000000000000000000000001
10000000000000000000002000000001
10000000000000000000000000000001
10000000000000000000000000000001
10000000000000000000000000000001
10000011111111111111111111000001
10000000000000000000000000000001
10000000000000000000000000000001
10000000000000000000000000000001
11111111111111111111111111111111